1111111111111111111111
100P0000000000C0000001
1000000000E00000000001
10000000001000C0000001
1111111111111111111111
