11111111111111111111
1E0100000C0000011111
101C000P000000001111
100000000C0000000111
11111111111111111111
